Levels:
------------------------------------------------------------------------------------------------------------------------

 21 22 23 24 25 26 27 27 27 27 27 27 27 26 25 25 24 23 23 23 23 23 22 21 21 21 21 21 21 21 21 21 21 21 21 21 21 21 20 19

 21 22 23 24 25 26 27 28 28 28 28 28 27 26 26 25 24 24 24 24 24 23 22 22 22 22 22 22 22 22 22 22 22 22 22 22 22 21 20 19

 21 22 23 24 25 26 27 28 29 29 29 28 27 27 26 25 25 25 25 25 24 23 23 23 23 23 23 23 23 23 23 23 23 23 23 23 22 21 20 20

 21 22 23 24 25 26 27 28 29 30 29 28 28 27 26 26 26 26 26 25 24 23 24 24 24 24 24 24 24 24 24 24 24 24 24 23 22 21 21 21

 21 22 23 24 25 26 27 28 29 29 29 29 28 27 27 27 27 27 26 25 24 23 24 25 25 25 25 25 25 25 25 25 25 25 24 23 22 22 22 22

 21 22 23 24 25 26 27 28 28 29 30 29 28 28 28 28 28 27 26 25 24 23 24 25 26 26 26 26 26 26 26 26 26 25 24 23 23 23 23 23

 21 22 23 24 25 26 27 27 28 29 29 29 28 29 29 29 28 27 26 25 24 23 24 25 26 27 27 27 27 27 27 27 26 25 24 24 24 24 24 23

 21 22 23 24 25 26 26 27 28 28 28 28 28 29 30 29 28 27 26 25 24 23 24 25 26 27 28 28 28 28 28 27 26 25 25 25 25 25 24 23

 21 22 23 24 25 25 26 27 27 27 27 27 28 29 29 29 28 27 26 25 24 23 24 25 26 27 28 29 29 29 28 27 26 26 26 26 26 25 24 23

 21 22 23 24 24 25 26 26 26 26 26 27 28 28 28 28 28 27 26 25 24 23 24 25 26 27 28 29 30 29 28 27 27 27 27 27 26 25 24 23

 21 22 23 23 24 25 25 25 25 25 26 27 27 27 27 27 27 27 26 25 24 23 24 25 26 27 28 29 29 29 28 28 28 28 28 27 26 25 24 23

 21 22 22 23 24 24 24 24 24 25 26 26 26 26 26 26 26 26 26 25 24 24 24 25 26 27 28 28 28 28 28 29 29 29 28 27 26 25 24 23

 21 21 22 23 23 23 23 23 24 25 25 25 25 25 25 25 25 25 25 25 25 25 25 25 26 27 27 27 27 27 28 29 30 29 28 27 26 25 24 23

 20 21 22 22 22 22 22 23 24 24 24 24 24 24 24 25 26 26 26 26 26 26 26 26 26 26 26 26 26 27 28 29 29 29 28 27 26 25 24 23

 20 21 21 21 21 21 22 23 23 23 23 23 24 25 25 25 26 27 27 27 27 27 27 27 26 25 25 25 26 27 28 28 28 28 28 27 26 25 24 23

 20 20 20 20 20 21 22 22 22 22 22 23 24 25 26 26 26 27 28 28 28 28 28 27 26 25 24 25 26 27 27 27 27 27 27 27 26 25 24 23

 19 19 19 19 20 21 21 21 21 21 22 23 24 25 26 27 27 27 28 29 29 29 28 27 26 25 24 25 26 26 26 26 26 26 26 26 26 25 24 23

 18 18 18 19 20 20 20 20 20 21 22 23 24 25 26 27 28 28 28 29 30 29 28 27 26 25 24 25 25 25 25 25 25 25 25 25 25 25 24 23

 17 17 18 19 19 19 19 19 20 21 22 23 24 25 26 27 28 29 29 29 29 29 28 27 26 25 24 24 24 24 24 24 24 24 24 24 24 24 24 23

 16 17 18 18 18 18 18 19 20 21 22 23 24 25 26 27 28 29 30 29 28 28 28 27 26 25 24 23 23 23 23 23 23 23 23 23 23 23 23 23

Blocks:
------------------------------------------------------------------------------------------------------------------------

  7  9 11 13 15 16 18 18 18 18 18 18 18 16 15 15 14 12 12 12 12 12 10  8  8  8  8  8  8  8  8  8  8  8  8  8  8  8  5  3

  7  9 11 13 15 16 18 21 21 21 21 21 18 16 16 15 14 14 14 14 14 12 10 10 10 10 10 10 10 10 10 10 10 10 10 10 10  8  5  3

  7  9 11 13 15 16 18 21 24 24 24 21 18 18 16 15 15 15 15 15 14 12 12 12 12 12 12 12 12 12 12 12 12 12 12 12 10  8  5  5

  7  9 11 13 15 16 18 21 24 29 24 21 21 18 16 16 16 16 16 15 14 12 14 14 14 14 14 14 14 14 14 14 14 14 14 12 10  8  8  8

  7  9 11 13 15 16 18 21 24 24 24 24 21 18 18 18 18 18 16 15 14 12 14 15 15 15 15 15 15 15 15 15 15 15 14 12 10 10 10 10

  7  9 11 13 15 16 18 21 21 24 30 24 21 21 21 21 21 18 16 15 14 12 14 15 17 17 17 17 17 17 17 17 17 15 14 12 12 12 12 12

  7  9 11 13 15 16 18 18 21 24 24 24 21 25 25 25 21 18 16 15 14 12 14 15 17 19 19 19 19 19 19 19 17 15 14 14 14 14 14 12

  7  9 11 13 15 16 16 18 21 21 21 21 21 25 31 25 21 18 16 15 14 12 14 15 17 19 22 22 22 22 22 19 17 15 15 15 15 15 14 12

  7  9 11 13 15 15 16 18 18 18 18 18 21 25 25 25 21 18 16 15 14 12 14 15 17 19 22 26 26 26 22 19 17 17 17 17 17 15 14 12

  7  9 11 13 13 15 16 16 16 16 16 18 21 21 21 21 21 18 16 15 14 12 14 15 17 19 22 26 32 26 22 19 19 19 19 19 17 15 14 12

  7  9 11 11 13 15 15 15 15 15 16 18 18 18 18 18 18 18 16 15 14 12 14 15 17 19 22 26 26 26 22 22 22 22 22 19 17 15 14 12

  7  9  9 11 13 13 13 13 13 15 16 16 16 16 16 16 16 16 16 15 14 14 14 15 17 19 22 22 22 22 22 27 27 27 22 19 17 15 14 12

  7  7  9 11 11 11 11 11 13 15 15 15 15 15 15 15 15 15 15 15 15 15 15 15 17 19 19 19 19 19 22 27 33 27 22 19 17 15 14 12

  6  7  9  9  9  9  9 11 13 13 13 13 13 13 13 15 17 17 17 17 17 17 17 17 17 17 17 17 17 19 22 27 27 27 22 19 17 15 14 12

  6  7  7  7  7  7  9 11 11 11 11 11 13 15 15 15 17 20 20 20 20 20 20 20 17 15 15 15 17 19 22 22 22 22 22 19 17 15 14 12

  6  6  6  6  6  7  9  9  9  9  9 11 13 15 17 17 17 20 23 23 23 23 23 20 17 15 14 15 17 19 19 19 19 19 19 19 17 15 14 12

  4  4  4  4  6  7  7  7  7  7  9 11 13 15 17 20 20 20 23 28 28 28 23 20 17 15 14 15 17 17 17 17 17 17 17 17 17 15 14 12

  2  2  2  4  6  6  6  6  6  7  9 11 13 15 17 20 23 23 23 28 34 28 23 20 17 15 14 15 15 15 15 15 15 15 15 15 15 15 14 12

  1  1  2  4  4  4  4  4  6  7  9 11 13 15 17 20 23 28 28 28 28 28 23 20 17 15 14 14 14 14 14 14 14 14 14 14 14 14 14 12

  0  1  2  2  2  2  2  4  6  7  9 11 13 15 17 20 23 28 35 28 23 23 23 20 17 15 14 12 12 12 12 12 12 12 12 12 12 12 12 12
